English Phonetic Alphabet
=================================


Vowels
---------------------

::

    [I] [ə] [ɒ|ɑ] [u] [Λ] [æ] [e|ɛ]

    [i:] [ə:|ɜː] [ɔ:] [u:] [ɑ:]

    [aI] [eI] [ɔI] [au|oʊ] [əu] [Iə] [eə] [uə]


Consonants
----------------------

::

    [p] [t] [k] [f] [θ] [s] [tr] [ts] [∫] [t∫]

    [b] [d] [g] [v] [ð] [z] [dr] [dz] [ʒ] [dʒ]

    [h] [m ] [n] [ŋ] [l] [r] [w] [j]


English Alphabet
-----------------------

::

    Aa	[eɪ]
    Bb	[biː]
    Cc	[siː]
    Dd	[diː]
    Ee	[iː]
    Ff	[ef]
    Gg	[dʒiː]
    Hh	[eɪtʃ]
    Ii	[aɪ]
    Jj	[dʒeɪ]
    Kk	[keɪ] 
    Ll	[el]
    Mm	[em]
    Nn	[en]
    Oo	[aʊ]
    Pp	[piː]
    Qq	[kjuː]
    Rr	[ɑːr]
    Ss	[es]
    Tt	[tiː]
    Uu	[juː]
    Vv	[viː]
    Ww	[ˈdʌbəl.juː]
    Xx	[eks]
    Yy	[waɪ]
    Zz	[ziː] or [zed]
